abandon	từ bỏ; bỏ rơi, ruồng bỏ
abode	nơi ở, sự lưu trú
abort	sẩy thai, làm sẩy thai, phá thai bỏ dở
abortion	sự sẩy thai, sự phá thai; sự nạo thai
abroad	ở nước ngoài, ra nước ngoài
absent	vắng mặt, đi nghỉ
abstraction	sự trừu tượng, cái nhìn trừu tượng
absurd	vô lý, ngu xuẩn, ngớ ngẩn
abuse	sự lạm dụng
academic	(thuộc) học viện; (thuộc) trường đại học
academy	học viện
access	lối vào, cửa vào, đường vào
accomplish	hoàn thành, làm xong, đạt được (mục tiêu...)
accord	phù hợp, hòa hợp
account	sự tính toán, tính toán
accountant	nhân viên kế toán, người giữ sổ sách kế toán
accurate	đúng đắn, chính xác, xác đáng
accuse	buộc tội, kết tội, tố cáo
accused	bị cáo
achieve	đạt được, giành được
acid	(hoá học) axit, chua
acknowledge	nhận, thừa nhận, công nhận
acquit	tha tội, tuyên bố trắng án
active	tích cực, nhanh nhẹn, lanh lợi
activity	sự tích cực, hoạt động
adamant	kỷ cương; cứng rắn
add	thêm vào, làm tăng thêm
address	địa chỉ
adequate	đủ, đầy đủ, tương xứng, xứng đáng
adjust	sửa lại cho đúng, điều chỉnh
administration	sự trông nom, sự quản lý; sự cai quản, sự cai trị
admit	nhận vào, thừa nhận, thú nhận
adopt	nhận làm con nuôi
adore	ngưỡng vọng, kính yêu
adroit	khéo léo, khéo tay
adult	người lớn, trưởng thành
adversity	sự bất hạnh, nghịch cảnh
affect	làm ảnh hưởng đến, làm tác động đến; chạm đến
affection	sự làm ảnh hưởng đến, sự làm tác động đến
affectionate	thương yêu, trìu mến
afford	kính yêu, kính mến
agency	tác dụng, lực
agenda	những việc phải làm
aggressive	hay gây hấn, hung hãn, hung hăng
agility	sự nhanh nhẹn, lanh lợi
agitate	khích động, làm xúc động
agree	đồng ý, chấp thuận
agreement	hiệp định, hiệp nghị
aid	sự giúp đỡ, sự viện trợ; cứu trợ
air	bầu không khí, không khí
aisle	cánh, gian bên trong
alarm	sự báo động, sự báo nguy
album	tập ảnh, quyển album
alien	xa lạ
alike	tương tự, giống nhau, như nhau
all rounder	người toàn diện, toàn năng
alliance	sự liên minh, khối liên minh
allow	cho phép, để cho
allure	sức quyến rũ; cám dỗ
ally	nước đồng minh, liên kết, liên minh
alone	một mình, trơ trọi, cô đơn, đơn độc
alteration	sự thay đổi, điều chỉnh
alternative	xen nhau; thay đổi nhau, thay phiên nhau
always	luôn luôn, mọi lúc
amateur	người nghiệp dư; có tính chất nghiệp dư
amaze	làm kinh ngạc, làm sửng sốt
ambassador	đại sứ
ambience	môi trường, không khí ở một địa điểm
ambition	đam mê, khát vọng, tham vọng
ambitious	có nhiều khát vọng, tham vọng
ambulance	xe cứu thương, xe cấp cứu
amiable	đáng mến, dễ thương
amicable	thân ái, thân mật, thân tình
amount	số lượng, lượng; cộng dồn lên đến
ample	phong phú, nhiều
amusing	có tính giải trí, buồn cười
angelic	tốt bụng, thánh thiện như thiên thần
angry	cáu giận, tức giận
anguish	nỗi đau đớn, khổ não
anniversary	ngày kỷ niệm; lễ kỷ niệm
annoy	quấy rầy, làm phiền
annual	hàng năm, từng năm
anonymous	giấu tên, ẩn danh, nặc danh
answer	câu trả lời; hồi đáp, trả lời
antiquated	cổ xưa, cũ kỹ, không hợp thời
antique	cổ, cổ xưa, theo lối cổ
anxiety	mối lo, mối lo âu, mối băn khoăn; sự lo lắng
anxious	lo âu, băn khoăn
anyhow	thế nào cũng được, cách nào cũng được
apart	về một bên, qua một bên, riêng ra, xa ra
appeal	sự kêu gọi; lời kêu gọi
appetite	sự ngon miệng, sự thèm ăn
apply	gắn vào, áp vào, ghép vào, đính vào
appointment	sự bổ nhiệm, chức vụ được bổ nhiệm
appreciate	đánh giá, cảm kích
appreciation	sự đánh giá cao, sự cảm kích
approach	sự đến gần, sự lại gần
appropriate	thích hợp, thích đáng
approval	sự tán thành, sự đồng ý, sự chấp thuận
approve	tán thành, chấp thuận, bằng lòng
area	diện tích, khu vực, lĩnh vực
argue	chứng tỏ, chỉ rõ
arrive	đến nơi, đạt tới
arrogant	kiêu ngạo, kiêu căng, ngạo mạn
article	bài báo
ashamed	xấu hổ, ngượng ngùng
aside	về một bên, sang một bên
ask	hỏi, yêu cầu
aspirin	(dược học) atpirin
aspiring	thiết tha, mong mỏi, khao khát
assault	cuộc tấn công, đột kích; tấn công, công kích
assembly	cuộc họp, dây chuyền
assertive	quả quyết, quyết đoán
assess	định giá, đánh giá
asset	tài sản, món quý
assist	giúp, giúp đỡ
associate	kết giao, kết hợp
assume	mang, khoác, có, lấy
assure	quả quyết, cam đoan
astonishing	gây bất ngờ, làm ngạc nhiên
atrocious	hung bạo, tàn ác, tồi tệ
attack	sự tấn công, tấn công
attempt	sự cố gắng, sự thử
attend	dự, có mặt
attire	quần áo, đồ trang điểm; mặc quần áo
attitude	thái độ, quan điểm
attorney	người được ủy quyền đại diện
attract	thu hút, hấp dẫn
attractive	hút, thu hút, hấp dẫn
auction	sự bán đấu giá
audacious	trơ tráo, táo bạo
audience	người nghe, thính giả, người xem, khán giả
authentic	đích thực, xác thực
authority	uy quyền, quyền lực, quyền thế
available	sẵn có, có thể dùng được
avenge	trả thù, báo thù
avoid	tránh, tránh xa, ngăn ngừa
aware	biết, nhận thấy, nhận thức thấy
away	rời xa, đi xa, biến đi
awful	đáng sợ, khủng khiếp; cực kỳ
awkward	vụng về, lúng túng, ngượng ngịu
baby	đứa trẻ
bachelor	người chưa vợ, người có bằng cử nhân
backward	về phía sau, giật lùi
bacon	thịt lưng lợn muối xông khói
badge	huy hiệu, phù hiệu; quân hàm
baggage	hành lý
bait	mồi, bả
bake	bỏ lò, nướng bằng lò
balance	cái cân, sự thăng bằng
balcony	ban công
bald	hói đầu, trọc trụi
ballet	ba lê, kịch múa
band	dải, băng, đai, nẹp, buộc dải, buộc băng
bane	nguyên do, nỗi khổ
bang	tóc mái, đánh mạnh, đánh đập
banner	ngọn cờ
bar	quầy bán rượu
barbecue	lợn (bò, cừu) nướng (quay) cả con
bare	trần, trần truồng, trọc, trần trụi
barely	công khai, rõ ràng
bargain	sự mặc cả, sự thoả thuận mua bán
barn	kho thóc
barrel	thùng tròn, lớn, thường được làm bằng gỗ hoặc kim loại
baseball	(thể dục,thể thao) bóng chày
basement	nền móng, móng (của một bức tường...)
bashful	rụt rè, bẽn lẽn
battery	bộ pin, ắc quy
bay	hồng, vịnh
beam	xà, dầm
bear	mang, cầm, vác, đội, đeo, ôm, chịu đựng
bearing	sự chịu đựng, sự sinh đẻ
beat	sự đập, tiếng đập
beaten	đập, nện (nền đường...)
beautiful	xinh đẹp, tuyệt vời
beg	ăn xin, xin xỏ, cầu xin
begin	bắt đầu, khởi đầu
beginning	lúc bắt đầu, căn nguyên
behalf	thay mặt cho ai đó
behave	ăn ở, đối xử, cư xử
behoove	có nhiệm vụ
believe	tin tưởng, cho rằng, nghĩ rằng
belly	bụng; dạ dày, phồng ra (cánh buồm...)
beloved	được yêu mến, được yêu quý, người yêu dấu, người yêu quý
below	ở dưới, cấp dưới, thấp hơn
bend	chỗ uốn, chỗ cong, cúi xuống, uốn cong
beneficial	có ích, có lợi
benefit	lợi, lợi ích
benevolent	nhân từ, từ thiện
bent	khiếu, sở thích; xu hướng, khuynh hướng
berserk	nổi quạu, cáu tiết
bet	đánh cược, sự đánh cược
betray	phản bội; phụ bạc, tiết lộ, để lộ
bias	thành kiến, sự thiên vị; hướng (ý kiến), gây thành kiến
bid	sự đặt giá, trả giá
big	to lớn
big-hearted	rộng lượng, hào hiệp
bigoted	mù quáng
birth	sự sinh đẻ, ra đời ngày thành lập
bite	cắn, sự cắn, miếng cắn
bizarre	kỳ quái, kỳ dị
blameless	không thể chê được
blank	chỗ trống; để trống, trống rỗng, bần thần
blanket bath	việc lau rửa cho người ốm liệt
blasé	dửng dưng, quá quen rồi
blend	hỗn hợp; trộn lẫn, pha trộn
blossom	hoa; ra hoa, trổ hoa
blot	vết nhơ, vết nhục; bôi nhọ, làm bẩn
blunder	điều sai lầm, điều ngớ ngẩn mắc lỗi ngớ ngẩn
boat	tàu thủy, thuyền
bold	táo bạo, gan dạ
bottom	phần đáy, dưới cùng
brave	gan dạ, dũng cảm; bất chấp, đương đầu với
bravery	tính gan dạ, sự dũng cảm
bread and butter	miếng ăn, kế sinh nhai
break	chỗ vỡ, sự rạn vỡ; làm gãy, làm đổ vỡ; ngắt, gián đoạn
brief	ngắn, vắn tắt; bản tóm tắt
broad	rộng, bao la, mênh mông
bumpy	gập ghềnh, mấp mô
bungalow	nhà một tầng
calamity	tai họa, thiên tai, tai ương
calendar	lịch
calm	bình tĩnh, điềm đạm
candid	thật thà, ngay thẳng, không xếp đặt
carriage	xe ngựa, sự chuyên chở hàng hóa
casual	tự nhiên, như thường lệ, bình thường; quần áo bình thường, không trang trọng
cease	thôi, ngừng
center	trung tâm; đặt làm trung tâm
certain	chắc chắn
change	sự thay đổi, biến đổi; thay đổi
chaos	sự hỗn loạn, lộn xộn
charismatic	có sức hút, lôi cuốn
chatterbox	người ba hoa, nói nhiều
chiefly	chủ yếu là, trước nhất
chilly	lạnh lẽo, giá lạnh
chocolate	sô cô la
choice	lựa chọn, sự chọn lựa; chất lượng tốt
choosy	khó chiều, kén chọn
chubby	mũm mĩm, mập mạp
circuit	chu vi, đường vòng quanh đi vòng quanh
civil	(thuộc) công dân lễ phép, lịch sự
clarify	làm sáng tỏ, giải thích
close	đóng kín, đóng cửa gần sát
coarse	thô (da, vải...)
collect	tập hợp, thu lượm, thu thập
collision	sự va đụng, xung đột
colossal	khổng lồ, to lớn
combative	hiếu chiến, thích gây gổ
combine	kết hợp, phối hợp
comical	hài hước, khôi hài
commence	khởi đầu, bắt đầu
comment	lời bình luận; bình luận, chỉ trích
commerce	sự buôn bán, giao thương, thương nghiệp
commotion	sự rung chuyển, chấn động
compassion	lòng thương cảm, lòng trắc ẩn
complex	khu phức hợp; phức tạp, rắc rối
complicated	phức tạp, tinh vi
compliment	lời khen; khen ngợi, ca tụng
comply	tuân theo, đồng ý làm theo
compress	ép, nén, đè
compulsion	sự cưỡng bức, ép buộc
concise	ngắn gọn, súc tích (văn)
confess	thú tội, nhận tội
confine	giam giữ, nhốt giữ lại
conflict	sự xung đột, cuộc va chạm; mâu thuẫn, chống đối
conform	thích ứng với, thích nghi
confuse	nhầm lẫn, gây khó hiểu
congested	đông nghịt, chật ních
connect	nối lại, kết nối
conquer	đoạt, xâm chiếm, chinh phục
consent	sự đồng tình, ưng thuận
considerate	ân cần, chu đáo
constraint	sự bắt ép, cưỡng ép, sự đè nén
contaminate	làm bẩn, gây ô nhiễm, làm hư hỏng
contemporary	đương thời, đương đại; người cùng thời
contrary	trái ngược
control	quyền hành, sự điều khiển; kiểm soát, kiềm chế
convert	người cải đạo; đổi, biến đổi
cordial	thân mật, chân thành
correct	sửa, hiệu chỉnh; đúng, chính xác
couch potato	người nghiện xem tv
counsel	sự bàn bạc, lời khuyên, lời chỉ bảo; khuyên răn, khuyên bảo
courage	sự can đảm, dũng khí
courteous	lịch sự, nhã nhặn
coy	bẽn lẽn, xấu hổ, rụt rè
crafty	láu cá, xảo quyệt
cram	sự nhồi sọ, nhồi nhét; tống vào, luyện thi
cranky	kỳ quặc, gàn dở
crazy	điên rồ, mất trí
creation	sự tạo thành, hình thành tác phẩm
creative	sáng tạo
creativity	óc sáng tạo, sự sáng tạo
cruel	độc ác, tàn bạo, tàn nhẫn
crumble	vỡ vụn, đổ nát; bẻ vụn, đập vụn
cunning	xảo quyệt, láu cá
cupboard	tủ đựng
curb	sự kiềm chế, sự nén lại; kìm hãm, hạn chế
curse	sự nguyền rủa, chửi rủa; nguyền rủa, báng bổ
daft	ngớ ngẩn, mất trí, gàn dở
daily	hằng ngày
dainty	nhã nhặn, xinh xắn, dễ thương
daring	táo bạo, mạnh bạo
dash	sự va đụng, va chạm
dated	lỗi thời, cũ kỹ
dawn	bình minh, rạng đông, bắt đầu rạng; lóe lên trong tâm trí
daybreak	lúc tảng sáng, rạng đông
deadly	làm chết người, trí mạng, chí tử
dearth	sự khan hiếm, đói kém
debate	cuộc tranh luận, tranh luận
deceased	đã chết, qua đời
decoration	sự trang hoàng, trang trí
dedicated	tận tâm, tận tụy
deduct	trừ đi, khấu trừ
defend	bảo vệ, biện hộ
defy	thách thức, thách đố, bất chấp
deliberate	chủ tâm, cố ý; cân nhắc, tính toán kỹ lưỡng
delicate	thanh nhã, thanh tú, tinh tế, khéo léo
delight	sự vui sướng, rạng rỡ
delighted	vui mừng, vui sướng
demeanor	phong thái, cử chỉ
demerit	điều lầm lỗi, đáng trách
democracy	nền dân chủ, chế độ dân chủ
democrat	người theo chế độ dân chủ
demolish	phá hủy, đánh đổ
demonstration	sự thấu hiểu, biểu hiện, sự chứng minh, thuyết minh, cuộc biểu tình, tuần hành
dense	dày đặc, đông đúc, rậm rạp
deny	từ chối, phủ nhận
descendant	hậu duệ, con cháu
desperate	tuyệt vọng, hết hy vọng
despise	xem thường, khinh thường
destiny	vận số, số mệnh
destitute	thiếu thốn, nghèo túng
destroy	phá hoại, phá huỷ, tàn phá
detain	ngăn cản, cản trở
deter	ngăn cản, cản trở
deteriorate	hư hỏng, giảm giá trị
determined	đã xác định rõ, quyết tâm, kiên quyết
detest	ghét cay đắng, ghê tởm
devastate	tàn phá, phá huỷ
dialogue	cuộc đối thoại, đoạn đối thoại
differ	không tán thành, không giống
difficulty	trở ngại, điều khó khăn
dilemma	thế tiến thoái lưỡng nan, tình trạng khó xử
direction	phương hướng, chiều sự chỉ bảo, hướng dẫn
dirty	dơ bẩn, đê tiện
disagree	không khớp, không hợp bất đồng, không đồng ý
disaster	thảm họa, tai ương
disclose	vạch trần, phơi bày
discount	giảm giá
disgrace	sự ô nhục, hổ thẹn; làm nhục nhã
dishonor	vô danh dự, thiếu uy tín
disobedient	không tuân thủ, làm trái
dispute	cuộc tranh cãi; bàn cãi, tranh luận
distant	xa cách, lạnh nhạt
distress	nỗi đau khổ, buồn bực; làm đau khổ, đau đớn
disturb	quấy rầy, khuấy động
disturbance	sự nhiễu loạn, náo động
diverse	đa dạng, linh tinh
divide	chia cắt ra, phân cắt
divulge	để lộ ra
docile	dễ bảo, dễ sai khiến
doubtful	ngờ vực, hồ nghi
drab	đều đều, buồn tẻ, xám xịt
dreadful	kinh khiếp, tồi tệ
dream	giấc mơ; nằm mơ thấy, mơ ước, tưởng tượng
dreary	tồi tàn, ảm đạm, thê lương
drowsy	mơ màng, ngủ gà ngủ gật, uể oải
dubious	lờ mờ, mơ hồ, không minh bạch, rõ ràng
dull	chậm hiểu, tối dạ; làm cho đần độn đục, mờ, cùn
dumb	câm, không có tiếng nói; làm điếng người
duplicate	bản sao
dusk	chạng vạng, lúc tối nha nhem
eager	hăm hở, háo hức
easy	dễ dàng
elated	phấn khích, phấn khởi
elective	chọn lọc bằng bầu cử
elegant	thanh lịch, tao nhã, đoan trang
elevate	nâng lên, đưa lên, nâng cao
elite	tinh tú, ưu tú
elusive	hay lảng tránh, thoái thác, khó nắm bắt
embarrass	làm xấu hổ, lúng túng
emphatically	mạnh mẽ, dứt khoát
empty	trống, rỗng, trống không
encourage	khuyên khích, cổ vũ
endorse	chứng thực, xác nhận, tán thành
engrossing	choán hết thời gian, quá cuốn hút
enjoy	thích thú, khoái
enlarge	mở rộng, phóng to
enormous	to lớn, khổng lồ
enquire	điều tra, thẩm tra
enraged	nổi giận, nổi khùng
entertaining	có tính giải trí, thú vị
entrance	sự đi vào, cổng vào, lối vào sự gia nhập, quyền tham gia
entrepreneur	người phụ trách hãng buôn
envious	thèm muốn, đố kỵ, ghen tị
envisage	dự tính, nhìn trước
envy	sự thèm muốn, nỗi ghen tỵ; them muốn, đố kỵ
epitome	bản tóm tắt
equivalent	vật tương đương; tương đương
escalate	leo thang (nghĩa bóng)
essential	(thuộc) bản chất, thiết yếu, cốt yếu
eternal	đời đời, vĩnh viễn, bất diệt
ethical	(thuộc) đạo đức, luân thường đạo lý
evaluate	ước lượng, định giá
evil	xấu xa, ác độc
exactly	chính xác, đúng như vậy
exaggerate	thổi phồng, phóng đại, làm quá lên
examine	khám xét, khảo sát
except	trừ ra, không kể đến
exceptional	khác thường, ngoại lệ
execute	thực hiện, thi hành
exemplary	gương mẫu, mẫu mực
exempt	được miễn (thuế...), không phải thực hiện
exhaust	làm kiệt quệ, dốc cạn sức lực
exit	lối ra, lối thoát; thoát ra, biến mất
expert	chuyên môn, thành thạo, thông thạo
explain	giải thích, lý giải
extinct	tuyệt chủng, tuyệt giống
extra	thêm, phụ vào; thêm vào; phần phụ thêm
extravagant	quá mức, quá độ
extremist	người cực đoan, quá khích
eye-opener	điều làm cho tỉnh ngộ, khai sáng
fair	hội chợ; đúng, hợp lý, công bằng
fairly	công bằng, không thiên vị kha khá
faithful	trung thành, chung thủy
famous	nổi tiếng, trứ danh
fanatic	người cuồng tín
fantastic	tuyệt vời, vô cùng tốt
far flung	xa rộng
fast	nhanh chóng, mau
fat	chất béo; béo phì, thừa cân
fatal	tiền định, không tránh được tai hại, gây tai họa, chí mạng
fate	định mệnh, số phận
fatigue	sự mệt mỏi, mệt nhọc
feasible	khả thi, có thể thực hiện được
feeble	yếu đuối, nhu nhược
ferry	phà; chở bằng phà
fetch	tìm về, đem về đấm thụi, thọi
fiction	điều hư cấu, tưởng tượng tiểu thuyết
fill	làm đầy, nhồi đầy
film	phim ảnh
fine	tốt, khỏe
finish	sự kết liễu, phần kết thúc; hoàn thành, kết thúc
fire	lửa, ánh lửa; đốt cháy; sa thải
firm	hãng, công ty; chắc chắn, vững chắc
fitting	phù hợp, thích hợp
flaw	thiếu sót, sai lầm
flawless	hoàn hảo, không tì vết
flinch	chùn bước, nao núng
flippant	suồng sã, nhả nhớt
flourish	nét trang trí hoa mỹ, thịnh vượng, phát đạt
fluke	sự may mắn
fond	yêu mến, yêu dấu
forbid	cấm, ngăn cấm
forcefully	mạnh mẽ, sinh động
formerly	trước đây, thuở xưa
fortunate	may mắn, thuận lợi
fraction	phần nhỏ, miếng nhỏ
fracture	(y học) sự gãy; chỗ gãy (xương)
fragile	dễ vỡ, yếu ớt
fraud	sự gian lận, lừa dối
freak	quái vật, thứ dị thường; quái dị
freezing	giá lạnh, rét mướt
frequently	thường xuyên
frigid	giá lạnh, nhạt nhẽo
frivolous	phù phiếm, nhẹ dạ
frosty	băng giá, giá rét
fuddy-duddy	người cổ hủ; cổ hủ, lỗi thời
fulfillment	hoàn chỉnh
fun	sự vui đùa, niềm vui thích; vui vẻ
function	chức năng; hoạt động, thực hiện chức năng
funny	buồn cười, hài hước
furious	giận dữ, điên tiết
future	tương lai
gain	lợi lộc, lợi ích; đạt được
garbage	rác rưởi
garish	lòe loẹt, sặc sỡ
gather	tập hợp, tụ họp hái, lượm
gaudy	lòe loẹt, cầu kỳ
gaunt	hoang vắng, thê lương, buồn thảm
gender	giống, giới tính
generous	rộng lượng, khoan thai
genuine	thành thật, chân thật
gesture	điệu bộ, cử chỉ, động tác
get	có được, kiếm được, nhận được
glad	vui lòng, sung sướng
glare	nhìn trừng trừng; cái nhìn, ánh nhìn giận dữ;
glimpse	cái nhìn lướt qua; nhìn thoáng qua
glitter	lấp lánh
gloomy	tối tăm, u ám, ảm đạm
glossy	bóng loáng, hào nhoáng
government	sự cai trị, thống trị chính phủ, chính quyền
grab	sự chộp, túm lấy; vồ, giật
gracious	hòa nhã, lịch thiệp
great	to lớn, vĩ đại
gregarious	thích đàn đúm, giao du
grief	nỗi sầu khổ
grim	dữ tợn, nhẫn tâm
grouse	sự càu nhàu; cằn nhằn, càu nhàu
gruesome	khủng khiếp, kinh khủng
grumble	sự càu nhàu, cằn nhằn; càu nhàu
guarantee	sự bảo đảm, cam đoan, bảo lãnh; hứa chắc chắn, cam đoan, bảo đảm
guard	sự đề phòng; bảo vệ, canh giữ
guilt	tội lỗi
guiltless	không phạm tội, không biết tí gì, không có tí nào
hallucination	ảo giác
halt	sự dừng lại, tạm nghỉ; cho dừng lại, lưỡng lự, do dự
handover	sự bàn giao
handsome	đẹp trai, ưa nhìn
handy	thuận tiện, sẵn tiện
hard	cứng, rắn, hà khắc; khắc nghiệt; hết sức
harmless	vô hại, không làm hại ai được
havoc	sự tàn phá
hazard	sự may rủi, mối nguy; phó thác cho may rủi, đánh bạo
hazy	lờ mờ, mơ hồ, ngà ngà say
heartless	vô tâm, nhẫn tâm
heed	chú ý, sự lưu ý, sự để ý
helpful	có ích, giúp ích
heroic	tính chất anh hùng, quả cảm, can đảm
hesitant	do dự, ngập ngừng, lưỡng lự
hint	lời gợi ý, bóng gió; gợi ý, ám chỉ
hire	sự cho thuê; cho thuê, mướn
honest	trung thực, chân thật
honorable	đáng tôn kính, đáng kính trọng
hop	bước nhảy; nhảy cẫng
horrible	xấu xa, khủng khiếp
huge	to lớn, đồ sộ
humble	khiêm tốn, nhún nhường
humiliate	làm nhục, làm bẽ mặt
hurry	sự vội vàng, hấp tấp; thúc giục, bắt làm gấp
hypnotize	thôi miên
identical	y hệt, giống nhau
idiot	đồ ngốc
ignore	phớt lờ, bỏ qua
illusion	ảo tưởng, ảo giác
imitate	theo gương, noi theo, mô phỏng
immaculate	trong trắng, không vết,  không khuyết điểm
immediate	trực tiếp, ngay tức thì, ngay lập tức
imminent	sắp xảy ra
impact	sự va chạm, tác động, ảnh hưởng
impaired	suy yếu, khiếm khuyết
impartial	công bằng, không thiên vị
impish	nghèo túng, thiếu thốn
implore	cầu khẩn, khẩn nài
impoverished	làm mất công dụng
inadequate	không tương xứng, không thích đáng
inappropriate	không thích hợp
incarnation	hiện thân, sự tạo hình
increase	sự tăng lên, tăng cao, tăng lên
indifferent	lãnh đạm, thờ ơ
indigenous	bản xứ
indistinct	không rõ ràng, lờ mờ
individual	cá nhân, người, cá thể; riêng lẻ, cá nhân, tách biệt
industrious	cần cù, siêng năng
inevitable	không thể tránh được, chắc chắn xảy ra
infamous	tai tiếng, ô nhục
infant	đứa bé còn ẵm ngửa
infect	nhiễm, lan truyền
inferior	thấp, cấp dưới
inform	báo tin, cho biết
infuriate	làm cho ai điên tiết, nổi cáu
ingenious	khéo léo, tài tình, mưu trí
inhabitant	người ở, dân cư, người cư trú
initiate	người đã được vỡ lòng, khai tâm; bắt đầu, khởi xướng
innocent	vô tội, ngây thơ
inroad	sự xâm nhập, đột nhập
insight	sự hiểu thấu, sự thật ngầm hiểu
insomnia	chứng mất ngủ
inspect	xét kỹ, thanh tra
instantly	ngay khi, ngay lập tức
instruction	hướng dẫn
insufficient	không đủ, thiếu thốn
interesting	thú vị, gây chú ý
intolerant	không dung thứ, không chịu được
intrude	xâm nhập, xâm phạm
invade	xâm lược, xâm chiếm
inventory	sự kiểm kê, bản kiểm kê
investigate	điều tra nghiên cứu
invincible	vô địch, bất khả chiến bại
irrelevant	không thích đáng, không liên quan
irritable	dễ cáu, cáu kỉnh
isolated	cô lập, bị cách ly
jealous	ghen tị, đố kỵ
jolly	vui tươi, vui vẻ; hết sức, lắm, quá; tán tỉnh
jovial	vui vẻ, vui tính
joy	sự vui mừng, hân hoan
joyful	vui mừng, hân hoan
jubilant	vui sướng, mừng rỡ
junior	người ít tuổi, ít thâm niên hơn; trẻ tuổi, ở cấp dưới
killing	sự giết chóc, tàn sát
kind-hearted	tốt bụng, có lòng tốt
laborious	cần cù, khó nhọc, gian khổ
lackadaisical	đa sầu, đa cảm, yếu đuối, ủy mị
learn	học tập, nghe được, biết được
leave	sự cho phép; để lại, bỏ lại, bỏ quên, bỏ đi, rời đi
lengthy	dài, dài dòng
lenient	nhân hậu, hiền hậu, khoan dung
lethal	làm chết người, gây chết người
lethargic	thờ ơ, lờ phờ
liable	khả thi, có khả năng xảy ra
liberal	rộng rãi, hào phóng tự do
libertarian	người theo chủ nghĩa tự do
license	sự cho phép, giấy phép, bằng, chứng chỉ; cho phép, cấp giấy phép
limitation	sự hạn chế, hạn định
listless	bơ phờ, lờ phờ
literary	(thuộc) văn chương, có tính văn chương, nghĩa bóng
little	nhỏ bé, ít ỏi
livelihood	cách sinh nhai, sinh kế
load	gánh nặng, trọng tải; chất, chở, chồng chất
loathe	ghê tởm, kinh hãi
local	tính địa phương; người dân địa phương
lofty	cao ngất, sừng sững kiêu căng, kiêu kỳ
logical	hợp lý, hợp với logic
loiter	đi tha thẩn, la cà
loyal	trung thành, trung kiên
lucid	tỉnh táo
lunar	(thuộc) mặt trăng
luxurious	sang trọng, lộng lẫy
magnanimous	hào hiệp, cao thượng
magnify	làm to ra, phóng to, mở rộng, khuếch đại
maiden	trinh nữ, cô gái đồng trinh; (thuộc) trinh nữ, thời con gái
mainly	chính, chủ yếu, phần lớn
maintain	giữ gìn, duy trì, bảo vệ, bảo dưỡng, kiên định với ý kiến
malfunction	sự trục trặc, làm việc sai chức năng
malicious	hiểm độc, có ác tâm
man-made	nhân tạo, do con người tạo ra
mansion	lâu đài, biệt thự
mate	bạn bè, người phụ việc, giúp việc; giao phối (con đực và con cái)
mature	chín, thuần thục, trưởng thành làm cho chín, làm cho hoàn thiện
meager	gầy gò, khẳng khiu, hom hem nghèo nàn, đạm bạc
mean	xấu tính, hèn hạ, bần tiện, bủn xỉn; muốn nói, có ý định, có ý muốn, dự định
meaningful	có ý nghĩa, đầy ý nghĩa
memento	vật kỷ niệm, vật lưu niệm
memorize	học thuộc, ghi nhớ
mental	(thuộc) tâm thần, tinh thần, trí tuệ, trí óc
mentor	người cố vấn, người hướng dẫn
merry	vui vẻ, thú vị, dễ chịu
mesmerize	thôi miên, mê hoặc, quyến rũ
messy	hỗn độn, lộn xộn, bừa bãi
midday	buổi trưa, giữa ngày
middle	giữa, ở giữa
mighty	mạnh, hùng cường, hùng mạnh, to lớn, vĩ đại, hùng vĩ
mild	nhẹ nhàng, êm dịu, dịu dàng, hòa nhã
militant	người chiến đấu; chiến đấu
mimic	giả, bắt chước
mind	tinh thần, trí tuệ, đầu óc
miniature	bức tiểu họa, hình thu nhỏ; nhỏ, thu nhỏ lại
minnow	cá tuế (họ cá chép)
mirage	ảo tưởng, ảo vọng
mischievous	tinh nghịch, tinh quái, ranh mãnh, láu lỉnh
misery	cảnh nghèo khổ, đáng thương, sự đau đớn, khổ sở
miss	cô gái, thiếu nữ, sự trượt, không trúng đích, sự thiếu vắng trượt, lỡ, nhỡ
mistake	lỗi, sai lầm, lỗi lầm; phạm sai lầm, hiểu sai, hiểu lầm
mistaken	sai lầm, bị hiểu sai
moderate	vừa phải, phải chăng, điều độ, ôn hòa, không quá khích; làm cho ôn hòa, giảng hòa, làm dịu nhẹ, tiết chế
modern	hiện đại, tân tiến
modest	khiêm tốn, nhún nhường, nhũn nhặn bình thường, giản dị, thùy mị, nhu mì
moist	ẩm; ẩm ướt, ướt lấp nhấp
mood	tâm trạng; tính khí, tâm tính, tính tình
moral	lời răn dạy, bài học; (thuộc) đạo đức, phẩm hạnh, có đạo đức
mortal	chết, không bất tử nguy đến tính mạng
mum	lặng yên, giữ kín
mural	tranh tường
myriad	vô số, lớn, nhiều vô cùng
mysterious	huyền bí, khó hiểu, bí ẩn
myth	thần thoại, chuyện hoang đường, lời đồn
narrative	chuyện kể, bài tường thuật
nasty	bẩn thỉu, dơ dáy
native	người gốc, thổ dân; (thuộc) địa phương
nausea	sự buồn nôn, sự kinh tởm
necessary	cần thiết, thiết yếu
needy	nghèo túng, thiếu thốn
negligible	không đáng kể
nervous	lo lắng, bồn chồn
neutral	trung lập, không có tính chất rõ ràng
niche	chỗ thích hợp; phù hợp với một nhóm nhỏ (ngách)
nippy	nhanh nhẹn, lanh lẹ, hoạt bát
noise	tiếng ồn, huyên náo, om sòm
nonchalant	thờ ơ, hờ hững, lãnh đạm, vô tình
noon	trưa, buổi trưa
normal	tình trạng bình thường, mức bình thường; thường, thông thường, bình thường
notable	người có danh vọng, người có địa vị uy quyền, có tiếng, trứ danh đáng kể, đáng chú ý
notify	báo, khai báo; thông báo, cho hay, cho biết
notorious	lừng danh, khét tiếng, tai tiếng
nuisance	sự phiền hà, mối phiền toái, gây khó chịu
nurture	sự nuôi dưỡng, giáo dục; nuôi nấng, dưỡng giục
obey	vâng lời, tuân theo, tuân lệnh
obscure	mờ mịt, tối tăm, không rõ nghĩa, mơ hồ, khó hiểu, không có tiếng tăm, vô danh
observe	quan sát, theo dõi tuân theo, tôn trọng
obsession	sự ám ảnh, nỗi ám ảnh
obsolete	cổ xưa, quá hạn, lỗi thời
obtain	đạt được, giành được, thu được
occult	sâu kín, huyền bí; che khuất, che lấp
offensive	cuộc tấn công, thế tấn công; xúc phạm, làm mất lòng; có tính tấn công, công kích
old fashioned	cổ hủ, lạc hậu, lỗi thời
operate	hoạt động, đang làm việc, thi hành
opportunity	cơ hội, thời cơ, dịp
opposite	điều trái ngược, sự đối lập; đối ngược, trái nhau; trước mặt, đối diện
optional	tùy ý, không bắt buộc
ordinary	bình thường, thông thường; điều bình thường, thông thường
original	nguyên bản, gốc
original	(thuộc) gốc, căn nguyên, đầu tiên, độc đáo; nguyên bản
ornament	đồ trang hoàng, trang trí, trang sức; trang hoàng
outgoing	dễ gần, thoải mái, hòa đồng
outrage	sự xúc phạm, làm tổn thương, sỉ nhục, sự oán hận, giận dữ; xúc phạm, lăng mạ, sỉ nhục
outrageous	tàn bạo, vô nhân đạo, quá chừng, thái quá xúc phạm, làm tổn thương
outskirts	phạm vi ngoài (một vấn đề...), vùng ngoại ô, xa trung tâm
outstanding	nổi bật, đáng chú ý, nổi tiếng, vượt trội
overjoyed	vui mừng khôn xiết
overlook	trông nom, quan sát, xem xét bỏ qua, tha thứ
overseas	nước ngoài, ngang qua biển
oversee	trông nom, giám thị, quan sát
overturned	sự lật đổ, đảo lộn; lật úp, đánh đổ, lật ngược
overwhelm	áp đảo, lất át, làm choáng ngợp tràn ngập, làm chôn vùi
pack	túi đeo, ba lô, đàn bầy; gói ghém, đóng gói, đóng hộp, xếp chặt, ních người
pail	cái thùng, xô, lượng đựng trong xô
part	phần, bộ phận, phần việc, nhiệm vụ, vai trò; chia thành từng phần, chia tách
particular	riêng biệt, cá biệt, đặc thù, ngoại lệ tường tận, tỉ mỉ, chi tiết
passion	cảm xúc mãnh liệt, sự đam mê, say mê
passport	hộ chiếu
patient	bệnh nhân, kiên nhẫn, nhẫn nại, bền chí
patriotic	yêu nước, ái quốc
peaceful	hòa bình, thái bình, yên tĩnh
peal	tràng hồi (sấm, cười...); rung, đánh từng hồi
pedestrian	người đi bộ, khách bộ hành; bằng chân, đi bộ, chán ngắt, tẻ nhạt
penniless	không có tiền, không xu dính túi, nghèo túng
pensive	trầm ngâm, sâu sắc
perception	sự nhận thức, am hiểu, sự sáng suốt
perhaps	có lẽ, có thể
permit	giấy phép, sự cho phép; cho phép, cho cơ hội
personal	cá nhân, riêng tư
photo	bức ảnh, tấm ảnh
pinnacle	cực điểm, đỉnh cao nhọn (núi, tảng đá...), điểm cao nhất, đỉnh cao (sự nghiệp...)
pleasant	làm thích ý, vừa ý vui vẻ, dễ thương
pluck	nhổ, bứt, hái
plump	thẳng thừng, không quanh co, úp mở bụ bẫm, phúng phính, đầy đặn
plunge	sự lao xuống, bước liều, sự lao đầu vào (khó khăn, nguy hiểm); nhúng, thọc, lao, đâm sâu vào
podium	bục đứng (cho giáo viên, người diễn thuyết)
polite	lễ phép, lịch thiệp, lịch sự
portion	phần chia, khẩu phần; chia phần, phân phát
possess	có, chiếm hữu, sở hữu
possibility	khả năng, sự có thể, triển vọng, tiềm năng
posture	tư thế, dáng điệu
potent	có hiệu lực, có hiệu nghiệm, có uy lực, có sức thuyết phục
powerful	hùng mạnh, hùng cường, có sức mạnh lớn, có tác động mạnh
practice	thói quen, thông lệ, sự thực hành, thực tiễn thực hành, luyện tập
precisely	đúng, chính xác, một cách chính xác
prejudiced	có thành kiến, biểu lộ thành kiến
preposterous	hoàn toàn trái với lý lẽ thường, vô lý hết sức, phi lý, ngược đời, ngớ ngẩn, lố bịch
preserve	bảo quản, giữ gìn, lưu giữ, bảo tồn
prestigious	có uy tín, có thanh thế, đem lại uy tín, đem lại thanh thế
prevail	thắng thế, chiếm ưu thế, đánh bại, thịnh hành, phổ biến khắp, lan khắp, thường xảy ra nhiều
prevent	ngăn cản, ngăn chặn, ngăn ngừa
previously	trước, trước đây
prior	trước; trước khi, quan trọng hơn
private	riêng tư, cá nhân, tư nhân
prize	giải thưởng, phần thưởng
procedure	thủ tục, chuỗi hành động
process	quá trình, quy trình, sự tiến triển; chế biến, xử lý
produce	sản lương, sản vật, sản phẩm, kết quả; trình ra, đưa ra, giơ ra
promote	thăng chức, xúc tiến, khuyến khích
prompt	mau, lẹ, nhanh chóng, ngay lập tức; xúi giục, thúc giục, thúc đẩy
propel	đẩy tới, thúc đẩy
propose	đề nghị, đề xuất, đưa ra đề cử, tiến cử, cầu hôn
prosper	thịnh vượng, làm cho thịnh vượng
prototype	nguyên mẫu, mẫu đầu tiên người, vật đầu tiên
provocative	khiêu khích, trêu chọc, kích thích, khêu gợi
provoke	khích, xúi giục, khêu gợi
prudent	thận trọng, cẩn thận, khôn ngoan
pudgy	(thông tục) ngắn và béo; béo lùn, mập lùn
punctual	đúng giờ, đúng thời điểm
punishment	sự trừng trị; sự bị trừng phạt
purchase	sự mua sắm, vật mua được; mua, sắm, tậu, trả giá
pure	nguyên chất, tinh khiết, trong lành, thanh khiết
quake	sự run rẩy, động đất; rung động, run, rẩy
quantity	lượng, số lượng, khối lượng
questionable	đáng ngờ, có vấn đề
quick	nhanh, mau, tính lanh lợi, hoạt bát, nhanh trí, sáng trí, nhanh
quickness	sự nhanh, sự mau chóng
racket	tiếng ồn, cảnh nhộn nhịp, huyên náo
ratify	thông qua, phê chuẩn
rational	có lý trí, dựa trên lý trí
ravage	sự tàn phá
raze	phá bằng, san bằng, phá trụi
recent	gần đây, xảy ra gần đây, mới đây, mới xảy ra
recipient	người nhận, nước nhận
reciprocate	trả, đền đáp lại; đáp lại
reduction	sự thu nhỏ, sự giảm bớt
refined	nguyên chất, đã lọc, đã tinh chế
refresh	làm khoẻ người, làm tỉnh táo
regret	lòng thương tiếc, hối tiếc, tiếc
rejuvenate	làm (ai) trẻ lại, làm (ai) khoẻ lại..
relax	nới lỏng, buông lỏng, lơi ra
remark	sự để ý, sự chú ý; nhận xét, bình luận
remorse	sự ăn năn, sự hối hận
remote	xa, xa xôi; hẻo lánh
renew	thay mới, làm mới lại
renowned	nổi tiếng, lừng danh
represent	đại diện, biểu trưng
republican	cộng hòa, mang đặc trưng của nền cộng hòa; người ủng hộ chế độ cộng hòa
repulsive	ghê tởm, đáng ghét, kinh tởm
reputable	có danh tiếng tốt; đáng kính trọng, đáng tin
resilient	bật nảy; co giãn, đàn hồi
resist	kháng cự, chống lại; chất cản màu
respond	hưởng ứng
response	sự trả lời; câu trả lời
rest	sự yên tâm, sự yên lòng, sự thanh thản, sự thư thái, nghỉ, nghỉ ngơi
restrict	hạn chế, giới hạn
retaliate	trả đũa, trả miếng, trả thù
retrograde	lùi lại, thụt lùi
reveal	bộc lộ, tiết lộ, làm lộ ra
revenge	(sự) trả thù, báo thù
rich	giàu, giàu có, dồi dào, phong phú
righteous	ngay thẳng, đạo đức, công bằng (người)
robust	tráng kiện, cường tráng; có sức khoẻ
rookie	lính mới, tân binh
roster	bảng phân công
rough	ráp, nhám, xù xì; miền đất gồ ghề
routine	công việc, thói quen thường ngày thường lệ, thường làm đều đặn
rude	khiếm nhã, bất lịch sự
ruin	sự đổ nát, sự hư hại nghiêm trọng; làm hỏng, làm tan nát, tàn phá
rush	cây bấc, cây cói; xông lên, lao vào
sack	bao tải, bao bố, bỏ vào bao; đóng bao
safety	sự an toàn, chắc chắn
sane	lành mạnh; đúng mực
satellite	vệ tinh, vệ tinh nhân tạo tay sai, người hầu
scanty	ít ỏi, thiếu, không đủ
scarcity	sự hiếm có
scrawny	gầy nhẳng; gầy giơ xương;
scribble	viết nguệch ngoạc, chữ viết cẩu thả
scrutinize	nhìn chăm chú, nhìn kỹ
secluded	hẻo lánh; không có nhiều người trông thấy
secret	thầm kín, bí mật; điều bí mật
section	bộ phận; nhóm tách biệt nằm trong khối lớn; chia thành phần;
sector	khu vực, lĩnh vực
secure	chắc chắn, bảo đảm; làm kiên cố
segment	đoạn, khúc, đốt, miếng; phân đoạn, phân đốt
seize	nắm; bắt; chộp
select	tuyển, được lựa chọn
selective	có tuyển chọn; dựa trên sự tuyển chọn
selfless	không ích kỷ; vị tha, luôn nghĩ đến người khác
senior	người lớn tuổi hơn, người có thâm niên, kinh nghiệm nhiều; cao hơn về tuổi, kinh nghiệm
sensible	có óc xét đoán, biểu lộ óc xét đoán
separate	khác nhau, riêng biệt, độc lập
serene	trong, sáng sủa, quang tạnh
settled	không thay đổi, không có khả năng thay đổi
severe	khắt khe, gay gắt
sewer	người khâu, người may vá
sheer	không giới hạn, không kiểm soát; thẳng đứng, vuông góc
shield	cái mộc, cái khiên; che chở, bảo vệ
shiny	sáng chói, bóng
shiver	(sự) run, sự rùng mình
shocking	gây ra căm phẫn, làm ghê tởm
shout	sự la hét, sự hò hét; tiếng gọi, tiếng kêu thét lớn
shove	xô đẩy thô bạo
showy	loè loẹt, phô trương
shrewd	khôn ngoan, sắc sảo
shrine	mồ, hòm đựng thánh cốt
sightseeing	sự tham quan
significant	đầy ý nghĩa, có tính chất gợi ý
silly	ngờ nghệch, ngớ ngẩn
simplify	làm đơn giản, đơn giản hoá
simultaneously	đồng thời, xảy ra cùng một lúc
sincere	thành thật, ngay thật, chân thật; thật; không giả vờ
skeptical	hoài nghi, đa nghi, hay ngờ vực
skillful	khéo tay; tài giỏi
skinny	gầy nhom, gầy trơ xương, rất gầy
sleeplessness	sự khó ngủ, sự không ngủ được
slender	mảnh khảnh, mảnh dẻ, mảnh mai
slick	bóng, mượt; trơn, tài tình, khéo léo; nhanh nhẹn
sluggish	chậm chạp, không nhanh nhẹn, không hoạt bát; uể oải, lờ đờ, lờ phờ
snub	hếch; ngắn và hơi vểnh lên ở chót
sociable	dễ gần gũi, dễ chan hoà, hoà đồng
soil	đất trồng, vết bẩn, vết nhơ; làm bẩn, làm dơ, vấy bẩn
solemn	trọng thể; chính thức
sorrow	sự đau khổ, sự buồn phiền; cảm thấy buồn bã
souvenir	vật kỷ niệm, đồ lưu niệm
sparkle	(sự) toé lửa, nhấp nháy, lấp lánh
sparse	thưa thớt, rải rác, lơ thơ; rải mỏng ra
specific	rành mạch, rõ ràng; cụ thể, đặc trưng, riêng biệt
spill	(sự) tràn ra, chảy ra, đổ ra
split	nứt, nẻ, chia ra, tách ra
spotless	không có đốm, không một vết nhơ; sạch sẽ, tinh tươm
sprint	sự chạy nhanh, sự chạy nước rút; cách chạy nước rút
stable	vững chắc; ổn định; kiên định, kiên quyết
state	trạng thái, tình trạng quốc gia, nhà nước
steady	vững, vững chắc, vững vàng; làm cho vững
stern	nghiêm nghị, nghiêm khắc; lạnh lùng
stiff	cứng, cứng rắn, kiên quyết
stigma	vết nhơ, điều sỉ nhục
stock	kho dự trữ, hàng cất trong kho; cung cấp; có sẵn trong kho
stoic	người khắc kỷ, người chịu đựng trong nghịch cảnh
stout	chắc, khoẻ, bền; người chắc mập, người mập mạp
strait	hẹp, chặt chẽ; tình cảnh khó khăn
strangle	siết cổ chết; bóp nghẹt
strenuous	hăm hở, tích cực; hăng hái; rất cố gắng
strike	cuộc đình công, bãi công; đánh, đập, tấn công
stringent	nghiêm ngặt, nghiêm khắc, chặt chẽ (về nội quy, luật pháp...)
struggle	sự đấu tranh, cuộc đấu tranh, cuộc chiến đấu; đấu tranh, chống lại
study	sự tìm tòi, sự nghiên cứu, sự điều tra về một vấn đề; học, nghiên cứu, xem rất cẩn thận
stunned	làm choáng váng, đánh bất tỉnh
subtle	phảng phất, huyền ảo, tinh vi, tinh tế
subtract	trừ
success	sự thành công, sự thắng lợi, sự thành đạt
suggest	đề nghị; đề xuất; gợi ý
supervise	giám sát; quản lý; kiểm soát
support	sự ủng hộ, người ủng hộ; hỗ trợ
surge	sự tràn; tràn (như) sóng
surplus	số dư, số thừa; số thặng dư
surprising	làm ngạc nhiên, làm kinh ngạc; đáng sửng sốt
sustain	đỡ; chống đỡ; giữ vững được (trong thời gian dài)
swift	mau, nhanh, lẹ
symbolize	tượng trưng, biểu tượng hóa
talkative	thích nói, hay nói; lắm mồm; ba hoa; bép xép
tall	cao; cao hơn trung bình; cao hơn xung quanh (người, đồ vật)
tame	thuần, đã thuần hoá (thú rừng..); dạy cho thuần
tandem	xe hai ngựa thắng con trước con sau
tangible	hữu hình, có thể sờ mó được
taut	căng, không bị chùng, căng thẳng (thân kinh, cơ bắp...)
tavern	quán rượu, quán trọ
temper	tính tình, tình khí, tâm tính
temporary	tạm thời, nhất thời, lâm thời
tender	mềm, dễ nhai, không dai (thịt)
tenet	nguyên lý; giáo lý; chủ nghĩa
tense	căng, căng thẳng, bồn chồn; làm cho căng thẳng, hồi hộp
terrible	khủng khiếp, gây khiếp sợ
thoughtless	không suy nghĩ, vô tư lự
thrifty	tiết kiệm, tằn tiện
thrive	thịnh vượng, làm cho thịnh vượng
thumping	to lớn, khổng lồ; hết mức, cực kỳ
tight	chặt, bó khít
timely	xảy ra đúng lúc, hợp thời
timid	rụt rè, nhút nhát, bẽn lẽn, dễ sợ hãi
tip	đầu, mút, đỉnh, chóp
toilet	nhà vệ sinh; bệ xí; phòng có nhà vệ sinh
traffic	sự đi lại, giao thông, vận tải
tragic	bi kịch, như bi kịch, theo kiểu bi kịch
tranquil	yên tĩnh, yên bình, lặng lẽ, không bị quấy rầy
tranquility	thay đổi, biến đổi (hình dáng, trạng thái, chức năng)
transform	ngắn ngủi; phù du; bóng chớp
transitory	ngắn ngủi, phù du, bóng chớp
tremble	sự run; cảm giác run, động tác run
triumph	sự chiến thắng, thành công lớn; chiến thắng
trivial	tầm thường, không đáng kể, ít quan trọng
trustworthy	đáng tin cậy
ultrasound	siêu âm, sóng siêu âm
umbrella	ô, dù
unchanging	không thay đổi, không đổi
unconquerable	không thể chinh phục được, không thể chế ngự được
uncooked	chưa nấu chín, còn sống
unfortunate	không may, rủi ro, bất hạnh
unimportant	không quan trọng, không đáng kể
unintelligent	không thông minh, tối dạ
unkind	không tốt; độc ác, tàn nhẫn
unlucky	không gặp may, không may mắn, đem lại vận rủi, bất hạnh, xui, rủi, đen đủi
unoccupied	nhàn rỗi, rảnh rỗi, không bận (thời gian) không có người ở, trống, bỏ không (đất...)
unpretentious	không khoe khoang, không phô trương, khiêm tốn
unrelated	không kể lại, không thuật lại, không có liên quan
unstoppable	quyết tâm
unusual	hiếm, không thông thường, lạ, khác thường đáng chú ý, đặc sắc; đặc biệt
unwilling	không muốn, không có ý định, không sẵn lòng, miễn cưỡng
update	cập nhật, hiện đại hóa; sự cập nhật
upstanding	dựng ngược, dựng đứng lên
urge	sự thúc đẩy, thôi thúc; thúc giục
urgent	gấp, khẩn cấp, cấp bách
utilize	dùng, sử dụng; tận dụng
vacant	trống, rỗng
vague	mơ hồ, lờ mờ, mập mờ, không rõ ràng (cách hiểu, sự nhận thức)
valiant	anh dũng, anh hùng
valour	sự dũng cảm (nhất là trong chiến tranh)
vanquish	thắng, đánh bại, chế ngự, khắc phục, vượt qua
variety	sự đa dạng, nhiều thứ, đủ loại, những thứ khác nhau
vary	biến đổi, thay đổi, khác nhau
vast	rộng lớn, mênh mông, bao la
vendor	người bán dạo (bán thực phẩm hoặc các thứ lặt vặt khác ở quầy ngoài trời)
verdict	lời tuyên án, lời phán quyết
versatile	nhiều mặt, nhiều phương diện, toàn diện
viable	có thể làm được, khả thi
victory	sự chiến thắng, sự thắng lợi
vigorous	sôi nổi, mãnh liệt, mạnh mẽ, hoạt bát, đầy sinh lực
vile	ghê tởm tồi tệ
violent	mãnh liệt, hung tợn
virtuous	có đạo đức tốt, cho thấy có đạo đức tốt
voluntary	tự ý, tự nguyện, tự giác, tình nguyện
vulgar	thiếu thẩm mỹ, khiếm nhã, tục tĩu
waiver	sự bỏ, sự từ bỏ, sự khước từ; giấy từ bỏ, giấy khước từ
wardrobe	tủ quần áo
warlike	(thuộc) chiến tranh, thích gây sự, hiếu chiến
wealthy	giàu, giàu có
weird	không bình thường, khác thường, kỳ lạ, khó hiểu
wide	rộng, rộng lớn
willingly	sẵn lòng, vui lòng tự ý, tự nguyện
win	sự thắng cuộc; thắng cuộc, thắng trận
wisecrack	lời nói lém lỉnh; nói lém lỉnh
withdraw	rút, rút lui
withstand	giữ vững, trụ lại, cưỡng lại, chịu đựng, chống lại
woe	sự đau buồn, nỗi phiền muộn
worn	mòn, hỏng (vì sử dụng quá nhiều)
yell	sự kêu la, tiếng la hét; kêu la, la hét
yield	sản lượng, hoa lợi (thửa ruộng); hiệu suất (máy...)
